################
#         #    #
#  @ #    #    #
#    #    #    #
#    #    #    #
### ##### ### ##
#    #         #
#    #    #    #
#    #    #    #
#    #    #    #
#### ###########
#    #    #    #
#              #
#    #    #    #
#    #    #    #
################
