################
#    #         #
#  @ #    #    #
#    #    #    #
#    #    #    #
#### ### ## ####
#    #    #    #
#    #    #    #
#    #    #    #
#    #    #    #
# ######### ####
#    #    #    #
#         #    #
#    #    #    #
#    #         #
################
