################
#    #    #    #
#  @ #         #
#    #    #    #
#         #    #
#### ######### #
#    #         #
#    #    #    #
#    #    #    #
#    #    #    #
######## ## ####
#    #    #    #
#    #    #    #
#    #    #    #
#         #    #
################
