################
#    #    #    #
#  @      #    #
#    #    #    #
#    #    #    #
####### #### ###
#    #    #    #
#    #    #    #
#    #    #    #
#    #    #    #
### #### ### ###
#         #    #
#    #    #    #
#    #    #    #
#    #         #
################
