################
#    #    #    #
#  @ #    #    #
#    #    #    #
#    #    #    #
# ###### ##### #
#    #    #    #
#    #    #    #
#    #    #    #
#    #    #    #
# ###### ##### #
#    #    #    #
#    #    #    #
#    #    #    #
#              #
################
