################
#    #    #    #
#  @ #    #    #
#         #    #
#    #    #    #
### ####### ####
#    #    #    #
#    #    #    #
#    #    #    #
#    #    #    #
## ### ####### #
#    #         #
#    #    #    #
#    #    #    #
#         #    #
################
