################
#    #    #    #
#  @      #    #
#    #    #    #
#    #    #    #
######### ### ##
#    #         #
#    #    #    #
#    #    #    #
#         #    #
### ######### ##
#    #    #    #
#         #    #
#    #    #    #
#    #    #    #
################
