################
#    #    #    #
#  @ #    #    #
#         #    #
#    #    #    #
## ##### ## ####
#    #    #    #
#    #    #    #
#    #    #    #
#    #    #    #
# ####### #### #
#    #    #    #
#    #    #    #
#    #         #
#    #    #    #
################
