################
#              #
#  @ #    #    #
#    #    #    #
#    #    #    #
######## ##### #
#    #    #    #
#    #    #    #
#    #    #    #
#         #    #
# ############ #
#    #    #    #
#    #    #    #
#    #    #    #
#    #         #
################
