################
#    #    #    #
#  @      #    #
#    #         #
#    #    #    #
############# ##
#    #    #    #
#    #    #    #
#    #    #    #
#              #
############# ##
#    #    #    #
#         #    #
#    #         #
#    #    #    #
################
