################
#         #    #
#  @ #  #      #
#  # #    #  # #
#    #    #    #
######## #######
#    #    #    #
#    # #  #    #
#         #  # #
#    #    #    #
### ######### ##
#         #    #
#    #    #    #
#    #         #
#    # #  #  # #
################
