################
#    #    #    #
#  @ #         #
#    #    #    #
#    #    #    #
# ##### ##### ##
#    #    #    #
#    #    #    #
#    #    #    #
#    #    #    #
### ### #### ###
#    #    #    #
#    #    #    #
#         #    #
#    #    #    #
################
