################
#    #    #    #
#  @ #    #    #
#              #
#    #    #    #
## ########### #
#    #    #    #
#    #    #    #
#    #         #
#    #    #    #
#######  #######
#    #    #    #
#    #         #
#    #    #    #
#         #    #
################
