################
#    #    #    #
#  @ #         #
#         #    #
#    #    #    #
############ ###
#         #    #
#    #    #    #
#    #         #
#    #    #    #
### ############
#    #         #
#         #    #
#    #    #    #
#    #    #    #
################
