################
#    #    #    #
#         #  @ #
#    #         #
#    #    #    #
### ############
#    #         #
#    #    #    #
#    #    #    #
#         #    #
############## #
#    #    #    #
#         #    #
#    #    #    #
#    #         #
################
