################
#    #    #    #
#  @      #    #
#    #    #    #
#    #    #    #
# ############ #
#    #         #
#    #    #    #
#    #    #    #
#         #    #
#### ######### #
#    #    #    #
#    #    #    #
#    #         #
#    #    #    #
################
