################
#    #    #    #
#  @ #         #
#    #    #    #
#         #    #
# #### #########
#    #    #    #
#    #    #    #
#    #         #
#    #    #    #
#### ######### #
#    #    #    #
#         #    #
#    #    #    #
#    #    #    #
################
