################
#    #    #    #
#  @      #    #
#    #    #    #
#    #         #
###### #########
#    #         #
#    #    #    #
#    #    #    #
#    #    #    #
## ########## ##
#    #    #    #
#         #    #
#    #    #    #
#    #         #
################
