################
#    #    #    #
#  @ #         #
#         #    #
#    #    #    #
####### ########
#    #    #    #
#    #    #    #
#    #         #
#    #    #    #
### #### #######
#    #    #    #
#    #    #    #
#         #    #
#    #         #
################
